INFIRMIER	position
COORDINATEUR	position
H/F	O
MAISON	company
D'ACCUEIL	company
PIERRE	company
GUICHENEY	company
-	O
Le	city
Bourgneuf-la-Forêt	city
-LRB-	O
53	code_postal
-RRB-	O
2	salary
557	salary
$	salary
par	salary
mois	salary
-	O
CDI	contrat_type
Gestion	hard_skills
des	hard_skills
hébergements	hard_skills
Coordination	hard_skills
des	hard_skills
prestations	hard_skills
de	hard_skills
soin	hard_skills
Management	hard_skills
et	hard_skills
gestion	hard_skills
du	hard_skills
personnel	hard_skills
soignant	hard_skills
Organisation	hard_skills
du	hard_skills
travail	hard_skills
et	hard_skills
gestion	hard_skills
des	hard_skills
moyens	hard_skills
Suivi	hard_skills
des	hard_skills
règles	hard_skills
d'hygiène	hard_skills
et	hard_skills
de	hard_skills
sécurité	hard_skills
Pilotage	hard_skills
des	hard_skills
projets	hard_skills
Travail	hard_skills
avec	hard_skills
les	hard_skills
partenaires	hard_skills
Type	O
d'emploi	O
:	O
CDI	contrat_type
Salaire	O
:	O
2	salary
557	salary
$	salary
/	O
mois	salary
Expérience	O
exigée	O
:	O
infirmier	experience
coordinateur	experience
:	O
1	experience
an	experience
